****************************************
*.................**...................*
*...D............***..C................*
*...............***....................*
*..............***.....................*
*......................................*
*......................................*
*......................................*
*......................................*
*.......................*****..........*
*.....*************************........*
*.....******................*****......*
*..C..*****........C........******.....*
*.....****..................******.....*
**********..................*****......*
*...........................***........*
*......................................*
*......................................*
*......................................*
*..........***.........................*
*..........*****************************
*........***...........................*
*......***.............................*
*......***.............................*
*......***.............................*
*......***.............******..........*
*......***...S.....************........*
*......***.......****..................*
*......***.......****..................*
*........************.C................*
*................****..................*
*.................***..................*
*.............C....************........*
*..................***********.........*
*..................**********..........*
*............**************............*
*..............**********..............*
*......................................*
***....................................*
*****..................................*
*******................................*
****************************************
