********************
*.D................*
*..................*
*................C.*
*..................*
*..................*
*..................*
*...............S..*
*..................*
********************