********************
*..................*
*..D...............*
*................C.*
*..................*
*..................*
*......M...........*
*...............S..*
*..................*
********************
